############
#        O  #
#   P   ####
#           #####
#######         #
#O   ##      X  #
#    ##         #
#               #
#      XX        #
#      #         O#
###################
