#########################
#      O               O#
# X      ################
#   ##   #
#   ##   #
#   ##   #########################
#       O    #       #       # P #
#            #       #       #   #
#   X    #       #       #     X #
#        #       #       #       #
##################################
